11111111111111111111111111111
12222225222220122220022222201
15000020000020170000030000501
12011120111170170111120111201
12011120111100170111120111501
12222220077777777700501111101
15000070020000500020020000501
15011170120111111150120111501
15555530122220122220155555501
10000070100020120000150000001
11111170111100100111100111111
00000170157777777750120100000
00000130150000000050120100000
11111170150110001150120111111
15555575550100000150222255501
10000070050100000150050000001
11111170150111111150150111111
00000170155555555550150100000
00000170150000000050150100000
11111170150111111150150111111
15222070022250155522222255501
15000070000050150000050000501
15011170111150150111150111501
12772177777777777777770177201

